1111111111111111111
10CC010000000000001
1PE0000010000000011
1011C01100000000001
1011111000000000001
1000011000000010011
1001000100001000101
1111111111111111111