111111111111111111111111111111111111111111111111111111111111111
1000010C01100001000110000100011000010001100001000110000100C1111
10010P0C1110010001110010000111001000011100100001110010000111111
1010E0110110100011011010001101101000110110100011011010001101111
10100C000110100000011010000001101000000110100000011010000001111
1010C0110110100011011010001101101000110110100011011010001101111
10010C010110010001011001000101100100010110010001011001000101111
100100010110010001011001000101100100010110010001011001000101111
100100010110010001011001000101100100010110010001011001000101111
100100010110010001011001000101100100010110010001011001000101111
100100010110010001011C01000101100100010110010001011001000101111
100100010110010001011001000101100100010110010001011001000101111
10010001011C010001011001000101100100010110010001011001000101111
101000C00000100000000010000000001000000000100000000010000001111
100000000000000000000000000000000000000000000000000000000000001
100000001110000000000000000000000000000000000000000000000000111
100000000000000C000000000011111111111111111C0000000000000000001
100000000000000000000000000000000000000000000000000000000000001
100000000000000000000000000000000000000000000000000000000000001
1000000000111111C1111111000000000000000000111111111000000000001
100000000000000000000000000000000000CCC000000000000000000000001
100000000000000000000000000000000000000000000000000000000000001
100000000000000000000000000000000000000000000000000000000000001
100000001111111111100000000000000000000000111111111111110000001
100000000000000000000000000000000000000000000000000000000000001
1000000000CCC000000000000000000000000000000000011111111111111C1
111111111111111111111111111111111111111111111111111111111111111
111111111111111111111111111111111111111111111111111111111111111